4 4 4 4 4 4 4 4 4 4 4 4 4 4 4 -1
4 4 4 4 4 4 4 4 4 4 4 4 4 4 4 -1
4 4 4 4 4 4 4 4 4 4 4 4 4 4 4 -1
4 4 4 4 4 4 4 4 4 4 4 4 4 4 4 -1
4 4 4 4 4 4 4 4 4 4 4 4 4 4 4 -1
4 4 4 4 4 4 4 4 4 4 4 4 4 4 4 -1
4 4 4 4 4 4 4 4 4 4 4 4 4 4 4 -1
4 4 4 4 4 4 4 4 4 4 4 4 4 4 4 -1
4 4 4 4 4 4 4 4 4 4 4 4 4 4 4 -1
4 4 4 4 4 4 4 4 4 4 4 4 4 4 4 -1
4 4 4 4 4 4 4 4 4 4 4 4 4 4 4 -1
4 4 4 4 4 4 4 4 4 4 4 4 4 4 4 -1
4 4 4 4 4 4 4 4 4 4 4 4 4 4 4 -1
4 4 4 4 4 4 4 4 4 4 4 4 4 4 4 -1
4 4 4 4 4 4 4 4 4 4 4 4 4 4 4 -1
4 4 4 4 4 4 4 4 4 4 4 4 4 4 4 -1
4 4 4 4 4 4 4 4 4 4 4 4 4 4 4 
-2 

5 5 5 5 5 5 5 5 5 5 5 5 5 5 5 -1
5 6 6 6 6 6 6 6 6 6 6 6 6 6 5 -1
5 6 6 6 6 6 6 6 6 6 6 6 6 6 5 -1
5 6 6 6 6 6 6 6 6 6 6 6 6 6 5 -1
5 6 6 6 6 6 6 6 6 6 6 6 6 6 5 -1
5 6 6 7 7 7 7 7 7 7 7 7 6 6 5 -1
5 6 6 7 7 7 7 7 7 7 7 7 6 6 5 -1
5 6 6 7 7 7 7 7 7 7 7 7 6 6 5 -1
5 6 6 7 7 7 7 7 7 7 7 7 6 6 5 -1
5 6 6 7 7 7 7 7 7 7 7 7 6 6 5 -1
5 6 6 7 7 7 7 7 7 7 7 7 6 6 5 -1
5 6 6 6 6 6 6 6 6 6 6 6 6 6 5 -1
5 6 6 6 6 6 6 6 6 6 6 6 6 6 5 -1
5 6 6 6 6 6 6 6 6 6 6 6 6 6 5 -1
5 6 6 6 6 6 6 6 6 6 6 6 6 6 5 -1
5 6 6 6 6 6 6 6 6 6 6 6 6 6 5 -1
5 5 5 5 5 5 5 5 5 5 5 5 5 5 5 
-2 

5 5 5 5 5 5 5 5 5 5 5 5 5 5 5 -1
5 2 2 2 2 2 2 2 2 2 2 2 2 2 5 -1
5 2 2 2 2 2 2 2 2 2 2 2 2 2 5 -1
5 2 2 2 2 2 2 3 2 2 2 2 2 2 5 -1
5 2 2 2 2 2 3 10 3 2 2 2 2 2 5 -1
5 2 2 8 9 9 3 3 3 9 9 8 2 2 5 -1
5 2 2 9 0 0 0 0 0 0 0 9 2 2 5 -1
5 2 2 9 0 0 0 0 0 0 0 9 2 2 5 -1
5 2 2 9 0 0 0 0 0 0 0 9 2 2 5 -1
5 2 2 9 0 0 0 0 0 0 0 9 2 2 5 -1
5 2 2 8 9 9 8 0 8 9 9 8 2 2 5 -1
5 2 2 2 2 2 0 0 0 2 2 2 2 2 5 -1
5 2 2 2 2 2 0 0 0 2 2 2 2 2 5 -1
5 2 2 2 2 2 0 0 0 2 2 2 2 2 5 -1
5 2 2 2 2 0 0 0 0 0 2 2 2 2 5 -1
5 2 2 2 2 0 0 0 0 0 2 2 2 2 5 -1
5 5 5 5 0 0 0 0 0 0 0 5 5 5 5 
-2 

0 0 0 0 0 0 0 0 0 0 0 0 0 0 0 -1
0 0 0 0 0 0 0 0 0 0 0 0 0 0 0 -1
0 0 0 0 0 0 0 0 0 0 0 0 0 0 0 -1
0 0 0 0 0 0 0 3 0 0 0 0 0 0 0 -1
0 0 0 0 0 0 3 11 3 0 0 0 0 0 0 -1
0 0 0 8 9 9 3 0 3 9 9 8 0 0 0 -1
0 0 0 9 0 0 0 0 0 0 0 9 0 0 0 -1
0 0 0 1 0 0 0 0 0 0 0 1 0 0 0 -1
0 0 0 1 0 0 0 0 0 0 0 1 0 0 0 -1
0 0 0 9 0 0 0 0 0 0 0 9 0 0 0 -1
0 0 0 8 1 1 8 0 8 1 1 8 0 0 0 -1
0 0 0 0 0 0 0 0 0 0 0 0 0 0 0 -1
0 0 0 0 0 0 0 0 0 0 0 0 0 0 0 -1
0 0 0 0 0 0 0 0 0 0 0 0 0 0 0 -1
0 0 0 0 0 0 0 0 0 0 0 0 0 0 0 -1
0 0 0 0 0 0 0 0 0 0 0 0 0 0 0 -1
0 0 0 0 0 0 0 0 0 0 0 0 0 0 0
-2 

0 0 0 0 0 0 0 0 0 0 0 0 0 0 0 -1
0 0 0 0 0 0 0 0 0 0 0 0 0 0 0 -1
0 0 0 0 0 0 0 0 0 0 0 0 0 0 0 -1
0 0 0 0 0 0 0 3 0 0 0 0 0 0 0 -1
0 0 0 0 0 0 3 0 3 0 0 0 0 0 0 -1
0 0 0 8 9 9 3 3 3 9 9 8 0 0 0 -1
0 0 0 9 0 0 0 0 0 0 0 9 0 0 0 -1
0 0 0 1 0 0 0 0 0 0 0 1 0 0 0 -1
0 0 0 1 0 0 0 0 0 0 0 1 0 0 0 -1
0 0 0 9 0 0 0 0 0 0 0 9 0 0 0 -1
0 0 0 8 1 1 8 8 8 1 1 8 0 0 0 -1
0 0 0 0 0 0 0 0 0 0 0 0 0 0 0 -1
0 0 0 0 0 0 0 0 0 0 0 0 0 0 0 -1
0 0 0 0 0 0 0 0 0 0 0 0 0 0 0 -1
0 0 0 0 0 0 0 0 0 0 0 0 0 0 0 -1
0 0 0 0 0 0 0 0 0 0 0 0 0 0 0 -1
0 0 0 0 0 0 0 0 0 0 0 0 0 0 0
-2 

0 0 0 0 0 0 0 0 0 0 0 0 0 0 0 -1
0 0 0 0 0 0 0 0 0 0 0 0 0 0 0 -1
0 0 0 0 0 0 0 0 0 0 0 0 0 0 0 -1
0 0 0 0 0 0 0 3 0 0 0 0 0 0 0 -1
0 0 0 0 0 0 3 0 3 0 0 0 0 0 0 -1
0 0 0 8 9 9 9 3 9 9 9 8 0 0 0 -1
0 0 0 9 0 0 0 0 0 0 0 9 0 0 0 -1
0 0 0 9 0 0 0 0 0 0 0 9 0 0 0 -1
0 0 0 9 0 0 0 0 0 0 0 9 0 0 0 -1
0 0 0 9 0 0 0 0 0 0 0 9 0 0 0 -1
0 0 0 8 9 9 9 9 9 9 9 8 0 0 0 -1
0 0 0 0 0 0 0 0 0 0 0 0 0 0 0 -1
0 0 0 0 0 0 0 0 0 0 0 0 0 0 0 -1
0 0 0 0 0 0 0 0 0 0 0 0 0 0 0 -1
0 0 0 0 0 0 0 0 0 0 0 0 0 0 0 -1
0 0 0 0 0 0 0 0 0 0 0 0 0 0 0 -1
0 0 0 0 0 0 0 0 0 0 0 0 0 0 0
-2 

0 0 0 0 0 0 0 0 0 0 0 0 0 0 0 -1
0 0 0 0 0 0 0 0 0 0 0 0 0 0 0 -1
0 0 0 0 0 0 0 0 0 0 0 0 0 0 0 -1
0 0 0 0 0 0 0 3 0 0 0 0 0 0 0 -1
0 0 5 5 5 5 3 0 3 5 5 5 5 0 0 -1
0 0 5 5 5 5 5 3 5 5 5 5 5 0 0 -1
0 0 5 5 5 5 5 5 5 5 5 5 5 0 0 -1
0 0 5 5 5 5 5 5 5 5 5 5 5 0 0 -1
0 0 5 5 5 5 5 5 5 5 5 5 5 0 0 -1
0 0 5 5 5 5 5 5 5 5 5 5 5 0 0 -1
0 0 5 5 5 5 5 5 5 5 5 5 5 0 0 -1
0 0 5 5 5 5 5 5 5 5 5 5 5 0 0 -1
0 0 0 0 0 0 0 0 0 0 0 0 0 0 0 -1
0 0 0 0 0 0 0 0 0 0 0 0 0 0 0 -1
0 0 0 0 0 0 0 0 0 0 0 0 0 0 0 -1
0 0 0 0 0 0 0 0 0 0 0 0 0 0 0 -1
0 0 0 0 0 0 0 0 0 0 0 0 0 0 0
-2 

0 0 0 0 0 0 0 0 0 0 0 0 0 0 0 -1
0 0 0 0 0 0 0 0 0 0 0 0 0 0 0 -1
0 0 0 0 0 0 0 0 0 0 0 0 0 0 0 -1
0 0 0 0 0 0 0 3 0 0 0 0 0 0 0 -1
0 0 0 0 0 0 3 0 3 0 0 0 0 0 0 -1
0 0 0 5 5 5 5 3 5 5 5 5 0 0 0 -1
0 0 0 5 5 5 5 5 5 5 5 5 0 0 0 -1
0 0 0 5 5 5 5 5 5 5 5 5 0 0 0 -1
0 0 0 5 5 5 5 5 5 5 5 5 0 0 0 -1
0 0 0 5 5 5 5 5 5 5 5 5 0 0 0 -1
0 0 0 5 5 5 5 5 5 5 5 5 0 0 0 -1
0 0 0 0 0 0 0 0 0 0 0 0 0 0 0 -1
0 0 0 0 0 0 0 0 0 0 0 0 0 0 0 -1
0 0 0 0 0 0 0 0 0 0 0 0 0 0 0 -1
0 0 0 0 0 0 0 0 0 0 0 0 0 0 0 -1
0 0 0 0 0 0 0 0 0 0 0 0 0 0 0 -1
0 0 0 0 0 0 0 0 0 0 0 0 0 0 0
-2 

0 0 0 0 0 0 0 0 0 0 0 0 0 0 0 -1
0 0 0 0 0 0 0 0 0 0 0 0 0 0 0 -1
0 0 0 0 0 0 0 0 0 0 0 0 0 0 0 -1
0 0 0 0 0 0 0 3 0 0 0 0 0 0 0 -1
0 0 0 0 0 0 3 0 3 0 0 0 0 0 0 -1
0 0 0 0 0 0 0 3 0 0 0 0 0 0 0 -1
0 0 0 0 5 5 5 5 5 5 5 0 0 0 0 -1
0 0 0 0 5 5 5 5 5 5 5 0 0 0 0 -1
0 0 0 0 5 5 5 5 5 5 5 0 0 0 0 -1
0 0 0 0 5 5 5 5 5 5 5 0 0 0 0 -1
0 0 0 0 0 0 0 0 0 0 0 0 0 0 0 -1
0 0 0 0 0 0 0 0 0 0 0 0 0 0 0 -1
0 0 0 0 0 0 0 0 0 0 0 0 0 0 0 -1
0 0 0 0 0 0 0 0 0 0 0 0 0 0 0 -1
0 0 0 0 0 0 0 0 0 0 0 0 0 0 0 -1
0 0 0 0 0 0 0 0 0 0 0 0 0 0 0 -1
0 0 0 0 0 0 0 0 0 0 0 0 0 0 0
-2 